z	() Z, the twenty-sixth and last letter of the English alphabet, is a vocal consonant. It is taken from the Latin letter Z, which came from the Greek alphabet, this having it from a Semitic source. The ultimate origin is probably Egyptian. Etymologically, it is most closely related to s, y, and j; as in glass, glaze; E. yoke, Gr. /, L. yugum; E. zealous, jealous. See Guide to Pronunciation, // 273, 274.
za	(n.) An old solfeggio name for B flat; the seventh harmonic, as heard in the or aeolian string; -- so called by Tartini. It was long considered a false, but is the true note of the chord of the flat seventh.
zabaism	(n.) Alt. of Zabism
zabian	(a. & n.) See Sabian.
zabism	(n.) See Sabianism.
zacco	(n.) See Zocco.
zachun	(n.) An oil pressed by the Arabs from the fruit of a small thorny tree (Balanites Aegyptiaca), and sold to piligrims for a healing ointment.
zaerthe	(n.) Same as Z/rthe.
zaffer	(n.) A pigment obtained, usually by roasting cobalt glance with sand or quartz, as a dark earthy powder. It consists of crude cobalt oxide, or of an impure cobalt arseniate. It is used in porcelain painting, and in enameling pottery, to produce a blue color, and is often confounded with smalt, from which, however, it is distinct, as it contains no potash. The name is often loosely applied to mixtures of zaffer proper with silica, or oxides of iron, manganese, etc.
zaim	(n.) A Turkish chief who supports a mounted militia bearing the same name.
zaimet	(n.) A district from which a Zaim draws his revenue.
zain	(n.) A horse of a dark color, neither gray nor white, and having no spots.
zalambdodont	(a.) Of or pertaining to a tribe (Zalambdodonta) of Insectivora in which the molar teeth have but one V-shaped ridge.
zalambdodont	(n.) One of the Zalambdodonta. The tenrec, solenodon, and golden moles are examples.
zamang	(n.) An immense leguminous tree (Pithecolobium Saman) of Venezuela. Its branches form a hemispherical mass, often one hundred and eighty feet across. The sweet pulpy pods are used commonly for feeding cattle. Also called rain tree.
zambo	(n.) The child of a mulatto and a negro; also, the child of an Indian and a negro; colloquially or humorously, a negro; a sambo.
zambos	(pl. ) of Zambo
zamia	(n.) A genus of cycadaceous plants, having the appearance of low palms, but with exogenous wood. See Coontie, and Illust. of Strobile.
zamindar	(n.) A landowner; also, a collector of land revenue; now, usually, a kind of feudatory recognized as an actual proprietor so long as he pays to the government a certain fixed revenue.
zamindari	(n.) The jurisdiction of a zamindar; the land possessed by a zamindar.
zamindary	(n.) Alt. of Zamindari
zamite	(n.) A fossil cycad of the genus Zamia.
zamouse	(n.) A West African buffalo (Bubalus brachyceros) having short horns depressed at the base, and large ears fringed internally with three rows of long hairs. It is destitute of a dewlap. Called also short-horned buffalo, and bush cow.
zampogna	(n.) A sort of bagpipe formerly in use among Italian peasants. It is now almost obsolete.
zander	(n.) A European pike perch (Stizostedion lucioperca) allied to the wall-eye; -- called also sandari, sander, sannat, schill, and zant.
zandmole	(n.) The sand mole.
zanies	(pl. ) of Zany
zante	(n.) See Zantewood.
zante currant	() A kind of seedless grape or raisin; -- so called from Zante, one of the Ionian Islands.
zantewood	(n.) A yellow dyewood; fustet; -- called also zante, and zante fustic. See Fustet, and the Note under Fustic.
zantewood	(n.) Satinwood (Chloroxylon Swietenia).
zantiot	(n.) A native or inhabitant of Zante, one of the Ionian Islands.
zany	(n.) A merry-andrew; a buffoon.
zany	(v. t.) To mimic.
zanyism	(n.) State or character of a zany; buffoonery.
zaphara	(n.) Zaffer.
zaphrentis	(n.) An extinct genus of cyathophylloid corals common in the Paleozoic formations. It is cup-shaped with numerous septa, and with a deep pit in one side of the cup.
zapotilla	(n.) See Sapodilla.
zaptiah	(n.) A Turkish policeman.
zarathustrian	(a.) Alt. of Zarathustric
zarathustric	(a.) Of or pertaining to Zarathustra, or Zoroaster; Zoroastrian.
zarathustrism	(n.) See Zoroastrianism.
zaratite	(n.) A hydrous carbonate of nickel occurring as an emerald-green incrustation on chromite; -- called also emerald nickel.
zareba	(n.) An improvised stockade; especially, one made of thorn bushes, etc.
zarnich	(n.) Native sulphide of arsenic, including sandarach, or realgar, and orpiment.
zarthe	(n.) A European bream (Abramis vimba).
zati	(n.) A species of macaque (Macacus pileatus) native of India and Ceylon. It has a crown of long erect hair, and tuft of radiating hairs on the back of the head. Called also capped macaque.
zauschneria	(n.) A genus of flowering plants. Zauschneria Californica is a suffrutescent perennial, with showy red flowers much resembling those of the garden fuchsia.
zax	(n.) A tool for trimming and puncturing roofing slates.
zayat	(n.) A public shed, or portico, for travelers, worshipers, etc.
zea	(n.) A genus of large grasses of which the Indian corn (Zea Mays) is the only species known. Its origin is not yet ascertained. See Maize.
zeal	(n.) Passionate ardor in the pursuit of anything; eagerness in favor of a person or cause; ardent and active interest; engagedness; enthusiasm; fervor.
zeal	(n.) A zealot.
zeal	(v. i.) To be zealous.
zealant	(n.) One who is zealous; a zealot; an enthusiast.
zealed	(a.) Full of zeal; characterized by zeal.
zealful	(a.) Full of zeal.
zealless	(a.) Wanting zeal.
zealot	(n.) One who is zealous; one who engages warmly in any cause, and pursues his object with earnestness and ardor; especially, one who is overzealous, or carried away by his zeal; one absorbed in devotion to anything; an enthusiast; a fanatical partisan.
zealotical	(a.) Like, or suitable to, a zealot; ardently zealous.
zealotism	(n.) The character or conduct of a zealot; zealotry.
zealotist	(n.) A zealot.
zealotry	(n.) The character and behavior of a zealot; excess of zeal; fanatical devotion to a cause.
zealous	(a.) Filled with, or characterized by, zeal; warmly engaged, or ardent, in behalf of an object.
zealous	(a.) Filled with religious zeal.
zebec	(n.) See Xebec.
zebra	(n.) Either one of two species of South African wild horses remarkable for having the body white or yellowish white, and conspicuously marked with dark brown or brackish bands.
zebrawood	(n.) A kind of cabinet wood having beautiful black, brown, and whitish stripes, the timber of a tropical American tree (Connarus Guianensis).
zebrawood	(n.) The wood of a small West Indian myrtaceous tree (Eugenia fragrans).
zebrawood	(n.) The wood of an East Indian tree of the genus Guettarda.
zebrine	(a.) Pertaining to, or resembling, the zebra.
zebu	(n.) A bovine mammal (Ros Indicus) extensively domesticated in India, China, the East Indies, and East Africa. It usually has short horns, large pendulous ears, slender legs, a large dewlap, and a large, prominent hump over the shoulders; but these characters vary in different domestic breeds, which range in size from that of the common ox to that of a large mastiff.
zebub	(n.) A large noxious fly of Abyssinia, which like the tsetse fly, is destructive to cattle.
zechin	(n.) See Sequin.
zechstein	(n.) The upper division of the Permian (Dyas) of Europe. The prevailing rock is a magnesian limestone.
zed	(n.) The letter Z; -- called also zee, and formerly izzard.
zedoary	(n.) A medicinal substance obtained in the East Indies, having a fragrant smell, and a warm, bitter, aromatic taste. It is used in medicine as a stimulant.
zeekoe	(n.) A hippopotamus.
zehner	(n.) An Austrian silver coin equal to ten kreutzers, or about five cents.
zein	(n.) A nitrogenous substance of the nature of gluten, obtained from the seeds of Indian corn (Zea) as a soft, yellowish, amorphous substance.
zemindar	(n.) Same as Zamindar.
zemindari	(n.) Same as Zamindary.
zemindary	(n.) Alt. of Zemindari
zemni	(n.) The blind mole rat (Spalax typhlus), native of Eastern Europe and Asia. Its eyes and ears are rudimentary, and its fur is soft and brownish, more or less tinged with gray. It constructs extensive burrows.
zenana	(n.) The part of a dwelling appropriated to women.
zend	(n.) Properly, the translation and exposition in the Huzv/resh, or literary Pehlevi, language, of the Avesta, the Zoroastrian sacred writings; as commonly used, the language (an ancient Persian dialect) in which the Avesta is written.
zend-avesta	(n.) The sacred writings of the ancient Persian religion, attributed to Zoroaster, but chiefly of a later date.
zendik	(n.) An atheist or unbeliever; -- name given in the East to those charged with disbelief of any revealed religion, or accused of magical heresies.
zenick	(n.) A South African burrowing mammal (Suricata tetradactyla), allied to the civets. It is grayish brown, with yellowish transverse stripes on the back. Called also suricat.
zenik	(n.) See Zenick.
zenith	(n.) That point in the visible celestial hemisphere which is vertical to the spectator; the point of the heavens directly overhead; -- opposed to nadir.
zenith	(n.) hence, figuratively, the point of culmination; the greatest height; the height of success or prosperity.
zenithal	(a.) Of or pertaining to the zenith.
zeolite	(n.) A term now used to designate any one of a family of minerals, hydrous silicates of alumina, with lime, soda, potash, or rarely baryta. Here are included natrolite, stilbite, analcime, chabazite, thomsonite, heulandite, and others. These species occur of secondary origin in the cavities of amygdaloid, basalt, and lava, also, less frequently, in granite and gneiss. So called because many of these species intumesce before the blowpipe.
zeolitic	(a.) Of or pertaining to a zeolite; consisting of, or resembling, a zeolite.
zeolitiform	(a.) Having the form of a zeolite.
zephyr	(n.) The west wind; poetically, any soft, gentle breeze.
zephyrus	(n.) The west wind, or zephyr; -- usually personified, and made the most mild and gentle of all the sylvan deities.
zequin	(n.) See Sequin.
zerda	(n.) The fennec.
zeriba	(n.) Same as Zareba.
zero	(n.) A cipher; nothing; naught.
zero	(n.) The point from which the graduation of a scale, as of a thermometer, commences.
zero	(n.) Fig.: The lowest point; the point of exhaustion; as, his patience had nearly reached zero.
zeroes	(pl. ) of Zero
zeros	(pl. ) of Zero
zest	(n.) A piece of orange or lemon peel, or the aromatic oil which may be squeezed from such peel, used to give flavor to liquor, etc.
zest	(n.) Hence, something that gives or enhances a pleasant taste, or the taste itself; an appetizer; also, keen enjoyment; relish; gusto.
zest	(n.) The woody, thick skin inclosing the kernel of a walnut.
zest	(v. t.) To cut into thin slips, as the peel of an orange, lemon, etc.; to squeeze, as peel, over the surface of anything.
zest	(v. t.) To give a relish or flavor to; to heighten the taste or relish of; as, to zest wine.
zested	(imp. & p. p.) of Zest
zesting	(p. pr. & vb. n.) of Zest
zeta	(n.) A Greek letter corresponding to our z.
zetetic	(a.) Seeking; proceeding by inquiry.
zetetic	(n.) A seeker; -- a name adopted by some of the Pyrrhonists.
zetetics	(a.) A branch of algebra which relates to the direct search for unknown quantities.
zeuglodon	(n.) A genus of extinct Eocene whales, remains of which have been found in the Gulf States. The species had very long and slender bodies and broad serrated teeth. See Phocodontia.
zeuglodont	() Any species of Zeuglodonta.
zeuglodonta	(n. pl.) Same as Phocodontia.
zeugma	(n.) A figure by which an adjective or verb, which agrees with a nearer word, is, by way of supplement, referred also to another more remote; as, "hic illius arma, hic currus fuit;" where fuit, which agrees directly with currus, is referred also to arma.
zeugmatic	(a.) Of or pertaining to zeugma; characterized by zeugma.
zeugobranchiata	(n. pl.) Same as Zygobranchia.
zeus	(n.) The chief deity of the Greeks, and ruler of the upper world (cf. Hades). He was identified with Jupiter.
zeuzerian	(n.) Any one of a group of bombycid moths of which the genus Zeuzera is the type. Some of these moths are of large size. The goat moth is an example.
zeylanite	(n.) See Ceylanite.
zibet	(n.) Alt. of Zibeth
zibeth	(n.) A carnivorous mammal (Viverra zibetha) closely allied to the civet, from which it differs in having the spots on the body less distinct, the throat whiter, and the black rings on the tail more numerous.
ziega	(n.) Curd produced from milk by adding acetic acid, after rennet has ceased to cause coagulation.
zietrisikite	(n.) A mineral wax, vert similar to ozocerite. It is found at Zietrisika, Moldavia, whence its name.
zif	(n.) The second month of the Jewish ecclesiastical year, corresponding to our May.
zigger	(v. i.) Alt. of Zighyr
zighyr	(v. i.) Same as Sicker.
zigzag	(n.) Something that has short turns or angles.
zigzag	(n.) A molding running in a zigzag line; a chevron, or series of chevrons. See Illust. of Chevron, 3.
zigzag	(n.) See Boyau.
zigzag	(a.) Having short, sharp turns; running this way and that in an onward course.
zigzag	(v. t.) To form with short turns.
zigzag	(v. i.) To move in a zigzag manner; also, to have a zigzag shape.
zigzagged	(imp. & p. p.) of Zigzag
zigzaggery	(n.) The quality or state of being zigzag; crookedness.
zigzagging	(p. pr. & vb. n.) of Zigzag
zigzaggy	(a.) Having sharp turns.
zilla	(n.) A low, thorny, suffrutescent, crucifeous plant (Zilla myagroides) found in the deserts of Egypt. Its leaves are boiled in water, and eaten, by the Arabs.
zillah	(n.) A district or local division, as of a province.
zimb	(n.) A large, venomous, two-winged fly, native of Abyssinia. It is allied to the tsetse fly, and, like the latter, is destructive to cattle.
ziment-water	(n.) A kind of water found in copper mines; water impregnated with copper.
zinc	(n.) An abundant element of the magnesium-cadmium group, extracted principally from the minerals zinc blende, smithsonite, calamine, and franklinite, as an easily fusible bluish white metal, which is malleable, especially when heated. It is not easily oxidized in moist air, and hence is used for sheeting, coating galvanized iron, etc. It is used in making brass, britannia, and other alloys, and is also largely consumed in electric batteries. Symbol Zn. Atomic weight 64.9.
zinc	(v. t.) To coat with zinc; to galvanize.
zincane	(n.) Zinc chloride.
zinced	() of Zinc
zincic	(a.) Pertaining to, containing, or resembling, zinc; zincous.
zincide	(n.) A binary compound of zinc.
zinciferous	(a.) Containing or affording zinc.
zincification	(n.) The act or process of applying zinc; the condition of being zincified, or covered with zinc; galvanization.
zincify	(v. t.) To coat or impregnate with zinc.
zincing	() of Zinc
zincing	(n.) The act or process of applying zinc; galvanization.
zincite	(n.) Native zinc oxide; a brittle, translucent mineral, of an orange-red color; -- called also red zinc ore, and red oxide of zinc.
zincked	(imp. & p. p.) of Zinc
zincking	(p. pr. & vb. n.) of Zinc
zincking	(n.) Alt. of Zincing
zincky	(a.) Pertaining to zinc, or having its appearance.
zinco-	() A combining form from zinc; in chemistry, designating zinc as an element of certain double compounds. Also used adjectively.
zinco-polar	(a.) Electrically polarized like the surface of the zinc presented to the acid in a battery, which has zincous affinity.
zincode	(n.) The positive electrode of an electrolytic cell; anode.
zincographer	(n.) An engraver on zinc.
zincography	(n.) The art or process of engraving or etching on zinc, in which the design is left in relief in the style of a wood cut, the rest of the ground being eaten away by acid.
zincoid	(a.) Pertaining to, or resembling, zinc; -- said of the electricity of the zincous plate in connection with a copper plate in a voltaic circle; also, designating the positive pole.
zincongraphic	(a.) Alt. of Zincongraphical
zincongraphical	(a.) Of or pertaining to zincography; as, zincographic processes.
zincous	(a.) Of, pertaining to, or containing, zinc; zincic; as, zincous salts.
zincous	(a.) Hence, formerly, basic, basylous, as opposed to chlorous.
zincous	(a.) Of or pertaining to the positive pole of a galvanic battery; electro-positive.
zingari	(pl. ) of Zingaro
zingaro	(n.) A gypsy.
zingel	(n.) A small, edible, freshwater European perch (Aspro zingel), having a round, elongated body and prominent snout.
zingiberaceous	(a.) Of or pertaining to ginger, or to a tribe (Zingibereae) of endogenous plants of the order Scitamineae. See Scitamineous.
zink	(n.) See Zinc.
zinkenite	(n.) A steel-gray metallic mineral, a sulphide of antimony and lead.
zinky	(a.) See Zincky.
zinnia	(n.) Any plant of the composite genus Zinnia, Mexican herbs with opposite leaves and large gay-colored blossoms. Zinnia elegans is the commonest species in cultivation.
zinnwaldite	(n.) A kind of mica containing lithium, often associated with tin ore.
zinsang	(n.) The delundung.
zinziberaceous	(a.) Same as Zingiberaceous.
zion	(n.) A hill in Jerusalem, which, after the capture of that city by the Israelites, became the royal residence of David and his successors.
zion	(n.) Hence, the theocracy, or church of God.
zion	(n.) The heavenly Jerusalem; heaven.
ziphioid	(n.) See Xiphioid.
zirco-	() A combining form (also used adjectively) designating zirconium as an element of certain double compounds; zircono-; as in zircofluoric acid, sodium zircofluoride.
zircofluoride	(n.) A double fluoride of zirconium and hydrogen, or some other positive element or radical; as, zircofluoride of sodium.
zircon	(n.) A mineral occurring in tetragonal crystals, usually of a brown or gray color. It consists of silica and zirconia. A red variety, used as a gem, is called hyacinth. Colorless, pale-yellow or smoky-brown varieties from Ceylon are called jargon.
zircona	(n.) Zirconia.
zirconate	(n.) A salt of zirconic acid.
zirconia	(n.) The oxide of zirconium, obtained as a white powder, and possessing both acid and basic properties. On account of its infusibility, and brilliant luminosity when incandescent, it is used as an ingredient of sticks for the Drummomd light.
zirconic	(a.) Pertaining to, containing, or resembling, zirconium; as, zirconic oxide; zirconic compounds.
zirconium	(n.) A rare element of the carbon-silicon group, intermediate between the metals and nonmetals, obtained from the mineral zircon as a dark sooty powder, or as a gray metallic crystalline substance. Symbol Zr. Atomic weight, 90.4.
zircono	() See Zirco-.
zirconoid	(n.) A double eight-sided pyramid, a form common with tetragonal crystals; -- so called because this form often occurs in crystals of zircon.
zither	(n.) An instrument of music used in Austria and Germany. It has from thirty to forty wires strung across a shallow sounding-board, which lies horizontally on a table before the performer, who uses both hands in playing on it. [Not to be confounded with the old lute-shaped cittern, or cithern.]
zittern	(n.) See Cittern.
zizania	(n.) A genus of grasses including Indian rice. See Indian rice, under Rice.
zizel	(n.) The suslik.
zoa	(pl. ) of Zoon
zoanthacea	(n. pl.) A suborder of Actinaria, including Zoanthus and allied genera, which are permanently attached by their bases.
zoantharia	(n. pl.) Same as Anthozoa.
zoantharian	(a.) Of or pertaining to the Zoantharia.
zoantharian	(n.) One of the Anthozoa.
zoanthodeme	(n.) The zooids of a compound anthozoan, collectively.
zoanthoid	(a.) Of or pertaining to the Zoanthacea.
zoanthropy	(n.) A kind of monomania in which the patient believes himself transformed into one of the lower animals.
zoanthus	(n.) A genus of Actinaria, including numerous species, found mostly in tropical seas. The zooids or polyps resemble small, elongated actinias united together at their bases by fleshy stolons, and thus forming extensive groups. The tentacles are small and bright colored.
zobo	(n.) A kind of domestic cattle reared in Asia for its flesh and milk. It is supposed to be a hybrid between the zebu and the yak.
zocco	(n.) Alt. of Zoccolo
zoccolo	(n.) Same as Socle.
zocle	(n.) Same as Socle.
zodiac	(n.) An imaginary belt in the heavens, 16  or 18  broad, in the middle of which is the ecliptic, or sun's path. It comprises the twelve constellations, which one constituted, and from which were named, the twelve signs of the zodiac.
zodiac	(n.) A figure representing the signs, symbols, and constellations of the zodiac.
zodiac	(n.) A girdle; a belt.
zodiacal	(a.) Of or pertaining to the zodiac; situated within the zodiac; as, the zodiacal planets.
zoea	(n.) A peculiar larval stage of certain decapod Crustacea, especially of crabs and certain Anomura.
zoetrope	(n.) An optical toy, in which figures made to revolve on the inside of a cylinder, and viewed through slits in its circumference, appear like a single figure passing through a series of natural motions as if animated or mechanically moved.
zohar	(n.) A Jewish cabalistic book attributed by tradition to Rabbi Simon ben Yochi, who lived about the end of the 1st century, a. d. Modern critics believe it to be a compilation of the 13th century.
zoic	(a.) Of or pertaining to animals, or animal life.
zoide	(n.) See Meride.
zoilean	(a.) Having the characteristic of Zoilus, a bitter, envious, unjust critic, who lived about 270 years before Christ.
zoilism	(n.) Resemblance to Zoilus in style or manner; carping criticism; detraction.
zoisite	(n.) A grayish or whitish mineral occurring in orthorhombic, prismatic crystals, also in columnar masses. It is a silicate of alumina and lime, and is allied to epidote.
zokor	(n.) An Asiatic burrowing rodent (Siphneus aspalax) resembling the mole rat. It is native of the Altai Mountains.
zollverein	(n.) Literally, a customs union; specifically, applied to the several customs unions successively formed under the leadership of Prussia among certain German states for establishing liberty of commerce among themselves and common tariff on imports, exports, and transit.
zomboruk	(n.) See Zumbooruk.
zona	(n.) A zone or band; a layer.
zonae	(pl. ) of Zona
zonal	(a.) Of or pertaining to a zone; having the form of a zone or zones.
zonar	(n.) A belt or girdle which the Christians and Jews of the Levant were obliged to wear to distinguish them from Mohammedans.
zonaria	(n. pl.) A division of Mammalia in which the placenta is zonelike.
zonate	(a.) Divided by parallel planes; as, zonate tetraspores, found in certain red algae.
zone	(n.) A girdle; a cincture.
zone	(n.) One of the five great divisions of the earth, with respect to latitude and temperature.
zone	(n.) The portion of the surface of a sphere included between two parallel planes; the portion of a surface of revolution included between two planes perpendicular to the axis.
zone	(n.) A band or stripe extending around a body.
zone	(n.) A band or area of growth encircling anything; as, a zone of evergreens on a mountain; the zone of animal or vegetable life in the ocean around an island or a continent; the Alpine zone, that part of mountains which is above the limit of tree growth.
zone	(n.) A series of planes having mutually parallel intersections.
zone	(n.) Circuit; circumference.
zone	(v. t.) To girdle; to encircle.
zoned	(a.) Wearing a zone, or girdle.
zoned	(a.) Having zones, or concentric bands; striped.
zoned	(a.) Zonate.
zoneless	(a.) Not having a zone; ungirded.
zonnar	(n.) See Zonar.
zonular	(a.) Of or pertaining to a zone; zone-shaped.
zonule	(n.) A little zone, or girdle.
zonulet	(n.) A zonule.
zonure	(n.) Any one of several of South African lizards of the genus Zonura, common in rocky situations.
zoo-	() A combining form from Gr. zwo^,n an animal, as in zoogenic, zoology, etc.
zoochemical	(a.) Pertaining to zoochemistry.
zoochemistry	(n.) Animal chemistry; particularly, the description of the chemical compounds entering into the composition of the animal body, in distinction from biochemistry.
zoochemy	(n.) Animal chemistry; zoochemistry.
zoochlorella	(n.) One of the small green granulelike bodies found in the interior of certain stentors, hydras, and other invertebrates.
zoocyst	(n.) A cyst formed by certain Protozoa and unicellular plants which the contents divide into a large number of granules, each of which becomes a germ.
zoocytia	(pl. ) of Zoocytium
zoocytium	(n.) The common support, often branched, of certain species of social Infusoria.
zoodendria	(pl. ) of Zoodendrium
zoodendrium	(n.) The branched, and often treelike, support of the colonies of certain Infusoria.
zooecia	(pl. ) of Zooecium
zooecium	(n.) One of the cells or tubes which inclose the feeling zooids of Bryozoa. See Illust. of Sea Moss.
zooerythrine	(n.) A peculiar organic red coloring matter found in the feathers of various birds.
zoogamous	(a.) Of or pertaining zoogamy.
zoogamy	(n.) The sexual reproduction of animals.
zoogenic	(a.) Of or pertaining to zoogeny, animal production.
zoogeny	(n.) Alt. of Zoogony
zoogeographical	(a.) Of or pertaining to zoography.
zoogeography	(n.) The study or description of the geographical distribution of animals.
zoogloea	(n.) A colony or mass of bacteria imbedded in a viscous gelatinous substance. The zoogloea is characteristic of a transitory stage through which rapidly multiplying bacteria pass in the course of their evolution. Also used adjectively.
zoogony	(n.) The doctrine of the formation of living beings.
zoographer	(n.) One who describes animals, their forms and habits.
zoographic	(a.) Alt. of Zoographical
zoographical	(a.) Of or pertaining to the description of animals.
zoographist	(n.) A zoographer.
zoography	(n.) A description of animals, their forms and habits.
zooid	(a.) Pertaining to, or resembling, an animal.
zooid	(n.) An organic body or cell having locomotion, as a spermatic cell or spermatozooid.
zooid	(n.) An animal in one of its inferior stages of development, as one of the intermediate forms in alternate generation.
zooid	(n.) One of the individual animals in a composite group, as of Anthozoa, Hydroidea, and Bryozoa; -- sometimes restricted to those individuals in which the mouth and digestive organs are not developed.
zooidal	(a.) Of or pertaining to a zooid; as, a zooidal form.
zoolatry	(n.) The worship of animals.
zoologer	(n.) A zoologist.
zoological	(a.) Of or pertaining to zoology, or the science of animals.
zoologically	(adv.) In a zoological manner; according to the principles of zoology.
zoologies	(pl. ) of Zoology
zoologist	(n.) One who is well versed in zoology.
zoology	(n.) That part of biology which relates to the animal kingdom, including the structure, embryology, evolution, classification, habits, and distribution of all animals, both living and extinct.
zoology	(n.) A treatise on this science.
zoomelanin	(n.) A pigment giving the black color to the feathers of many birds.
zoomorphic	(a.) Of or pertaining to zoomorphism.
zoomorphism	(n.) The transformation of men into beasts.
zoomorphism	(n.) The quality of representing or using animal forms; as, zoomorphism in ornament.
zoomorphism	(n.) The representation of God, or of gods, in the form, or with the attributes, of the lower animals.
zoon	(n.) An animal which is the sole product of a single egg; -- opposed to zooid.
zoon	(n.) Any one of the perfectly developed individuals of a compound animal.
zoonic	(a.) Of or pertaining to animals; obtained from animal substances.
zoonite	(n.) One of the segments of the body of an articulate animal.
zoonite	(n.) One of the theoretic transverse divisions of any segmented animal.
zoonomy	(n.) The laws of animal life, or the science which treats of the phenomena of animal life, their causes and relations.
zoonule	(n.) Same as Zoonite.
zoopathology	(n.) Animal pathology.
zoophaga	(n. pl.) An artificial group comprising various carnivorous and insectivorous animals.
zoophagan	(n.) A animal that feeds on animal food.
zoophagous	(a.) Feeding on animals.
zoophilist	(n.) A lover of animals.
zoophily	(n.) Love of animals.
zoophite	(n.) A zoophyte.
zoophoric	(a.) Bearing or supporting the figure of an animal; as, a zoophoric column.
zoophorous	(n.) The part between the architrave and cornice; the frieze; -- so called from the figures of animals carved upon it.
zoophyta	(n. pl.) An extensive artificial and heterogeneous group of animals, formerly adopted by many zoologists. It included the c/lenterates, echinoderms, sponges, Bryozoa, Protozoa, etc.
zoophyte	(v. i.) Any one of numerous species of invertebrate animals which more or less resemble plants in appearance, or mode of growth, as the corals, gorgonians, sea anemones, hydroids, bryozoans, sponges, etc., especially any of those that form compound colonies having a branched or treelike form, as many corals and hydroids.
zoophyte	(v. i.) Any one of the Zoophyta.
zoophytic	(a.) Alt. of Zoophytical
zoophytical	(a.) Of or pertaining to zoophytes.
zoophytoid	(a.) Pertaining to, or resembling, a zoophyte.
zoophytological	(a.) Of or pertaining to zoophytology; as, zoophytological observations.
zoophytology	(n.) The natural history zoophytes.
zoopraxiscope	(n.) An instrument similar to, or the same as, the, the phenakistoscope, by means of which pictures projected upon a screen are made to exhibit the natural movements of animals, and the like.
zoopsychology	(n.) Animal psychology.
zoosperm	(n.) One of the spermatic particles; spermatozoid.
zoosporangium	(n.) A spore, or conceptacle containing zoospores.
zoospore	(n.) A spore provided with one or more slender cilia, by the vibration of which it swims in the water. Zoospores are produced by many green, and by some olive-brown, algae. In certain species they are divided into the larger macrozoospores and the smaller microzoospores. Called also sporozoid, and swarmspore.
zoospore	(n.) See Swarmspore.
zoosporic	(a.) Of or pertaining to zoospores; of the nature of zoospores.
zootic	(a.) Containing the remains of organized bodies; -- said of rock or soil.
zootomical	(a.) Of or pertaining to zootomy.
zootomist	(n.) One who dissects animals, or is skilled in zootomy.
zootomy	(n.) The dissection or the anatomy of animals; -- distinguished from androtomy.
zootrophic	(a.) Of or pertaining to the nourishment of animals.
zoozoo	(n.) The wood pigeon.
zope	(n.) A European fresh-water bream (Abramis ballerus).
zopilote	(n.) The urubu, or American black vulture.
zoril	(n.) Same as Zorilla.
zorilla	(n.) Either one of two species of small African carnivores of the genus Ictonyx allied to the weasels and skunks.
zoroastrian	(a.) Of or pertaining to Zoroaster, or his religious system.
zoroastrian	(n.) A follower of Zoroaster; one who accepts Zoroastrianism.
zoroastrianism	(n.) The religious system of Zoroaster, the legislator and prophet of the ancient Persians, which was the national faith of Persia; mazdeism. The system presupposes a good spirit (Ormuzd) and an opposing evil spirit (Ahriman). Cf. Fire worship, under Fire, and Parsee.
zoroastrism	(n.) Same as Zoroastrianism.
zoster	(n.) Shingles.
zostera	(n.) A genus of plants of the Naiadaceae, or Pondweed family. Zostera marina is commonly known as sea wrack, and eelgrass.
zosterops	(n.) A genus of birds that comprises the white-eyes. See White-eye.
zouave	(n.) One of an active and hardy body of soldiers in the French service, originally Arabs, but now composed of Frenchmen who wear the Arab dress.
zouave	(n.) Hence, one of a body of soldiers who adopt the dress and drill of the Zouaves, as was done by a number of volunteer regiments in the army of the United States in the Civil War, 1861-65.
zounds	(interj.) An exclamation formerly used as an oath, and an expression of anger or wonder.
zoutch	(v. t.) To stew, as flounders, eels, etc., with just enough or liquid to cover them.
zubr	(n.) The aurochs.
zuche	(n.) A stump of a tree.
zuchetto	(n.) A skullcap covering the tonsure, worn under the berretta. The pope's is white; a cardinal's red; a bishop's purple; a priest's black.
zufolo	(n.) A little flute or flageolet, especially that which is used to teach birds.
zuisin	(n.) The American widgeon.
zulus	(n. pl.) The most important tribe belonging to the Kaffir race. They inhabit a region on the southeast coast of Africa, but formerly occupied a much more extensive country. They are noted for their warlike disposition, courage, and military skill.
zumbooruk	(n.) A small cannon supported by a swiveled rest on the back of a camel, whence it is fired, -- used in the East.
zumic	(n.) Alt. of Zumometer
zumological	(n.) Alt. of Zumometer
zumology	(n.) Alt. of Zumometer
zumometer	(n.) See Zymic, Zymological, etc.
zunyite	(n.) A fluosilicate of alumina occurring in tetrahedral crystals at the Zu/i mine in Colorado.
zwanziger	(n.) An Austrian silver coin equivalent to 20 kreutzers, or about 10 cents.
zygantra	(pl. ) of Zygantrum
zygantrum	(n.) See under Zygosphene.
zygapophyses	(pl. ) of Zygapophysis
zygapophysis	(n.) One of the articular processes of a vertebra, of which there are usually four, two anterior and two posterior. See under Vertebra.
zygenid	(n.) Any one of numerous species of moths of the family Zygaenidae, most of which are bright colored. The wood nymph and the vine forester are examples. Also used adjectively.
zygobranchia	(n. pl.) A division of marine gastropods in which the gills are developed on both sides of the body and the renal organs are also paired. The abalone (Haliotis) and the keyhole limpet (Fissurella) are examples.
zygobranchiate	(a.) Of or pertaining to the Zygobranchia.
zygodactyl	(n.) Alt. of Zygodactyle
zygodactylae	(n. pl.) The zygodactylous birds. In a restricted sense applied to a division of birds which includes the barbets, toucans, honey guides, and other related birds.
zygodactyle	(n.) Any zygodactylous bird.
zygodactyli	(n. pl.) Same as Scansores.
zygodactylic	(a.) Alt. of Zygodactylous
zygodactylous	(a.) Yoke-footed; having the toes disposed in pairs; -- applied to birds which have two toes before and two behind, as the parrot, cuckoo, woodpecker, etc.
zygoma	(n.) The jugal, malar, or cheek bone.
zygoma	(n.) The zygomatic process of the temporal bone.
zygoma	(n.) The whole zygomatic arch.
zygomatic	(a.) Of, pertaining to, or in the region of, the zygoma.
zygomorphic	(a.) Alt. of Zygomorphous
zygomorphous	(a.) Symmetrical bilaterally; -- said of organisms, or parts of organisms, capable of division into two symmetrical halves only in a single plane.
zygosis	(n.) Same as Conjugation.
zygosperm	(n.) A spore formed by the union of the contents of two similar cells, either of the same or of distinct individual plants. Zygosperms are found in certain orders of algae and fungi.
zygosphene	(n.) A median process on the front part of the neural arch of the vertebrae of most snakes and some lizards, which fits into a fossa, called the zygantrum, on the back part of the arch in front.
zygospore	(n.) Same as Zygosperm.
zygospore	(n.) A spore formed by the union of several zoospores; -- called also zygozoospore.
zylonite	(n.) Celluloid.
zymase	(n.) A soluble ferment, or enzyme. See Enzyme.
zyme	(n.) A ferment.
zyme	(n.) The morbific principle of a zymotic disease.
zymic	(a.) Pertaining to, or produced by, fermentation; -- formerly, by confusion, used to designate lactic acid.
zymogen	(n.) A mother substance, or antecedent, of an enzyme or chemical ferment; -- applied to such substances as, not being themselves actual ferments, may by internal changes give rise to a ferment.
zymogene	(n.) One of a physiological group of globular bacteria which produces fermentations of diverse nature; -- distinguished from pathogene.
zymogenic	(a.) Pertaining to, or formed by, a zymogene.
zymogenic	(a.) Capable of producing a definite zymogen or ferment.
zymologic	(a.) Alt. of Zymological
zymological	(a.) Of or pertaining to zymology.
zymologist	(n.) One who is skilled in zymology, or in the fermentation of liquors.
zymology	(n.) A treatise on the fermentation of liquors, or the doctrine of fermentation.
zymome	(n.) A glutinous substance, insoluble in alcohol, resembling legumin; -- now called vegetable fibrin, vegetable albumin, or gluten casein.
zymometer	(n.) Alt. of Zymosimeter
zymophyte	(n.) A bacteroid ferment.
zymose	(n.) Invertin.
zymosimeter	(n.) An instrument for ascertaining the degree of fermentation occasioned by the mixture of different liquids, and the degree of heat which they acquire in fermentation.
zymosis	(n.) A fermentation; hence, an analogous process by which an infectious disease is believed to be developed.
zymosis	(n.) A zymotic disease.
zymotic	(a.) Of, pertaining to, or caused by, fermentation.
zymotic	(a.) Designating, or pertaining to, a certain class of diseases. See Zymotic disease, below.
zyophyte	(n.) Any plant of a proposed class or grand division (Zygophytes, Zygophyta, or Zygosporeae), in which reproduction consists in the union of two similar cells. Cf. Oophyte.
zythem	(n.) See Zythum.
zythepsary	(n.) A brewery.
zythum	(n.) A kind of ancient malt beverage; a liquor made from malt and wheat.
