x	() X, the twenty-fourth letter of the English alphabet, has three sounds; a compound nonvocal sound (that of ks), as in wax; a compound vocal sound (that of gz), as in example; and, at the beginning of a word, a simple vocal sound (that of z), as in xanthic. See Guide to Pronunciation, // 217, 270, 271.
xanthamide	(n.) An amido derivative of xanthic acid obtained as a white crystalline substance, C2H5O.CS.NH2; -- called also xanthogen amide.
xanthate	(n.) A salt of xanthic; a xanthogenate.
xanthelasma	(n.) See Xanthoma.
xanthian	(a.) Of or pertaining to Xanthus, an ancient town on Asia Minor; -- applied especially to certain marbles found near that place, and now in the British Museum.
xanthic	(a.) Tending toward a yellow color, or to one of those colors, green being excepted, in which yellow is a constituent, as scarlet, orange, etc.
xanthic	(a.) Possessing, imparting, or producing a yellow color; as, xanthic acid.
xanthic	(a.) Of or pertaining to xanthic acid, or its compounds; xanthogenic.
xanthic	(a.) Of or pertaining to xanthin.
xanthide	(n.) A compound or derivative of xanthogen.
xanthidia	(pl. ) of Xanthidium
xanthidium	(n.) A genus of minute unicellular algae of the desmids. These algae have a rounded shape and are armed with glochidiate or branched aculei. Several species occur in ditches, and others are found fossil in flint or hornstone.
xanthin	(n.) A crystalline nitrogenous body closely related to both uric acid and hypoxanthin, present in muscle tissue, and occasionally found in the urine and in some urinary calculi. It is also present in guano. So called from the yellow color of certain of its salts (nitrates).
xanthin	(n.) A yellow insoluble coloring matter extracted from yellow flowers; specifically, the coloring matter of madder.
xanthin	(n.) One of the gaseous or volatile decomposition products of the xanthates, and probably identical with carbon disulphide.
xanthinine	(n.) A complex nitrogenous substance related to urea and uric acid, produced as a white powder; -- so called because it forms yellow salts, and because its solution forms a blue fluorescence like quinine.
xanthium	(n.) A genus of composite plants in which the scales of the involucre are united so as to form a kind of bur; cocklebur; clotbur.
xantho-	() A combining form from Gr. xanqo`s yellow; as in xanthocobaltic salts. Used also adjectively in chemistry.
xanthocarpous	(a.) Having yellow fruit.
xanthochroi	(n. pl.) A division of the Caucasian races, comprising the lighter-colored members.
xanthochroic	(a.) Having a yellowish or fair complexion; of or pertaining to the Xanthochroi.
xanthodontous	(a.) Having yellow teeth.
xanthogen	(n.) The hypothetical radical supposed to be characteristic of xanthic acid.
xanthogen	(n.) Persulphocyanogen.
xanthogenate	(n.) A salt of xanthic acid.
xanthogenic	(a.) Producing a yellow color or compound; xanthic. See Xanthic acid, under Xanthic.
xanthoma	(n.) A skin disease marked by the development or irregular yellowish patches upon the skin, especially upon the eyelids; -- called also xanthelasma.
xanthophane	(n.) The yellow pigment present in the inner segments of the retina in animals. See Chromophane.
xanthophyll	(n.) A yellow coloring matter found in yellow autumn leaves, and also produced artificially from chlorophyll; -- formerly called also phylloxanthin.
xanthopous	(a.) Having a yellow stipe, or stem.
xanthoproteic	(a.) Pertaining to, or derived from, xanthoprotein; showing the characters of xanthoprotein; as, xanthoproteic acid; the xanthoproteic reaction for albumin.
xanthoprotein	(n.) A yellow acid substance formed by the action of hot nitric acid on albuminous or proteid matter. It is changed to a deep orange-yellow color by the addition of ammonia.
xanthopuccine	(n.) One of three alkaloids found in the root of the yellow puccoon (Hydrastis Canadensis). It is a yellow crystalline substance, and resembles berberine.
xanthorhamnin	(n.) A glucoside extracted from Persian berries as a yellow crystalline powder, used as a dyestuff.
xanthorhiza	(n.) A genus of shrubby ranunculaceous plants of North America, including only the species Xanthorhiza apiifolia, which has roots of a deep yellow color; yellowroot. The bark is intensely bitter, and is sometimes used as a tonic.
xanthorhoea	(n.) A genus of endogenous plants, native to Australia, having a thick, sometimes arborescent, stem, and long grasslike leaves. See Grass tree.
xanthose	(n.) An orange-yellow substance found in pigment spots of certain crabs.
xanthosis	(n.) The yellow discoloration often observed in cancerous tumors.
xanthospermous	(a.) Having yellow seeds.
xanthous	(a.) Yellow; specifically (Ethnol.), of or pertaining to those races of man which have yellowish, red, auburn, or brown hair.
xanthoxylene	(n.) A liquid hydrocarbon of the terpene series extracted from the seeds of a Japanese prickly ash (Xanthoxylum pipertium) as an aromatic oil.
xanthoxylum	(n.) A genus of prickly shrubs or small trees, the bark and rots of which are of a deep yellow color; prickly ash.
xebec	(n.) A small three-masted vessel, with projecting bow stern and convex decks, used in the Mediterranean for transporting merchandise, etc. It carries large square sails, or both. Xebecs were formerly armed and used by corsairs.
xeme	(n.) An Arctic fork-tailed gull (Xema Sabinii).
xenelasia	(n.) A Spartan institution which prohibited strangers from residing in Sparta without permission, its object probably being to preserve the national simplicity of manners.
xenia	(pl. ) of Xenium
xenium	(n.) A present given to a guest or stranger, or to a foreign ambassador.
xenodochium	(n.) A house for the reception of strangers.
xenodochium	(n.) In the Middle Ages, a room in a monastery for the reception and entertainment of strangers and pilgrims, and for the relief of paupers. [Called also Xenodocheion.]
xenodochy	(n.) Reception of strangers; hospitality.
xenogamy	(n.) Cross fertilization.
xenogenesis	(n.) Same as Heterogenesis.
xenogenesis	(n.) The fancied production of an organism of one kind by an organism of another.
xenogenetic	(a.) Of or pertaining to xenogenesis; as, the xenogenetic origin of microzymes.
xenomania	(n.) A mania for, or an inordinate attachment to, foreign customs, institutions, manners, fashions, etc.
xenomi	(n. pl.) A suborder of soft-rayed fresh-water fishes of which the blackfish of Alaska (Dallia pectoralis) is the type.
xenopterygii	(n. pl.) A suborder of fishes including Gobiesox and allied genera. These fishes have soft-rayed fins, and a ventral sucker supported in front by the pectoral fins. They are destitute of scales.
xenotime	(n.) A native phosphate of yttrium occurring in yellowish-brown tetragonal crystals.
xenurine	(n.) A cabassou.
xenyl	(n.) The radical characteristic of xenylic compounds.
xenylic	(a.) Pertaining to, derived from, designating, certain amido compounds obtained by reducing certain nitro derivatives of diphenyl.
xeraphim	(n.) An old money of account in Bombay, equal to three fifths of a rupee.
xeres	(n.) Sherry. See Sherry.
xerif	(n.) A shereef.
xeriff	(n.) A gold coin formerly current in Egypt and Turkey, of the value of about 9s. 6d., or about $2.30; -- also, in Morocco, a ducat.
xeroderma	(n.) Ichthyosis.
xeroderma	(n.) A skin disease characterized by the presence of numerous small pigmented spots resembling freckles, with which are subsequently mingled spots of atrophied skin.
xeronate	(n.) A salt of xeronic acid.
xeronic	(a.) Pertaining to, or designating, an acid, C8H12O4, related to fumaric acid, and obtained from citraconic acid as an oily substance having a bittersweet taste; -- so called from its tendency to form its anhydride.
xerophagy	(n.) Among the primitive Christians, the living on a diet of dry food in Lent and on other fasts.
xerophilous	(a.) Drought-loving; able withstand the absence or lack of moisture.
xerophthalmia	(n.) An abnormal dryness of the eyeball produced usually by long-continued inflammation and subsequent atrophy of the conjunctiva.
xerophthalmy	(n.) Xerophthalmia.
xiphias	(n.) A genus of fishes comprising the common swordfish.
xiphias	(n.) The constellation Dorado.
xiphias	(n.) A comet shaped like a sword
xiphidium	(n.) A genus of plants of the order Haemodraceae, having two-ranked, sword-shaped leaves.
xiphioid	(a.) Of, pertaining to, or resembling, a cetacean of the genus Xiphius or family Xiphiidae.
xiphiplastra	(pl. ) of Xiphiplastron
xiphiplastron	(n.) The posterior, or fourth, lateral plate in the plastron of turtles; -- called also xiphisternum.
xiphisterna	(pl. ) of Xiphisternum
xiphisternum	(n.) The posterior segment, or extremity, of the sternum; -- sometimes called metasternum, ensiform cartilage, ensiform process, or xiphoid process.
xiphisternum	(n.) The xiphiplastron.
xiphius	(n.) A genus of cetaceans having a long, pointed, bony beak, usually two tusklike teeth in the lower jaw, but no teeth in the upper jaw.
xiphodon	(n.) An extinct genus of artiodactylous mammals found in the European Tertiary formations. It had slender legs, didactylous feet, and small canine teeth.
xiphoid	(a.) Like a sword; ensiform.
xiphoid	(a.) Of or pertaining to the xiphoid process; xiphoidian.
xiphoidian	(a.) Xiphoid.
xiphophyllous	(a.) Having sword-shaped leaves.
xiphosura	(n. pl.) See Xiphura.
xiphura	(n. pl.) Same as Limuloidea. Called also Xiphosura.
xylamide	(n.) An acid amide derivative of xylic acid, obtained as a white crystalline substance.
xylanthrax	(n.) Wood coal, or charcoal; -- so called in distinction from mineral coal.
xylate	(n.) A salt of xylic acid.
xylem	(n.) That portion of a fibrovascular bundle which has developed, or will develop, into wood cells; -- distinguished from phloem.
xylene	(n.) Any of a group of three metameric hydrocarbons of the aromatic series, found in coal and wood tar, and so named because found in crude wood spirit. They are colorless, oily, inflammable liquids, C6H4.(CH3)2, being dimethyl benzenes, and are called respectively orthoxylene, metaxylene, and paraxylene. Called also xylol.
xylenol	(n.) Any one of six metameric phenol derivatives of xylene, obtained as crystalline substances, (CH3)2.C6H3.OH.
xyletic	(a.) Pertaining to, or designating, a complex acid related to mesitylenic acid, obtained as a white crystalline substance by the action of sodium and carbon dioxide on crude xylenol.
xylic	(a.) Pertaining to, derived from, or related to, xylene; specifically, designating any one of several metameric acids produced by the partial oxidation of mesitylene and pseudo-cumene.
xylidic	(a.) Pertaining to, or designating, either one of two distinct acids which are derived from xylic acid and related compounds, and are metameric with uvitic acid.
xylidine	(n.) Any one of six metameric hydrocarbons, (CH3)2.C6H3.NH2, resembling aniline, and related to xylene. They are liquids, or easily fusible crystalline substances, of which three are derived from metaxylene, two from orthoxylene, and one from paraxylene. They are called the amido xylenes.
xylindein	(n.) A green or blue pigment produced by Peziza in certain kinds of decayed wood, as the beech, oak, birch, etc., and extracted as an amorphous powder resembling indigo.
xylite	(n.) A liquid hydrocarbon found in crude wood spirits.
xylitone	(n.) A yellow oil having a geraniumlike odor, produced as a side product in making phorone; -- called also xylite oil.
xylo-	() A combining form from Gr. xy`lon wood; as in xylogen, xylograph.
xylobalsamum	(n.) The dried twigs of a Syrian tree (Balsamodendron Gileadense).
xylocarpous	(a.) Bearing fruit which becomes hard or woody.
xylocopa	(n.) A genus of hymenopterous insects including the carpenter. See Carpenter bee, under Carpenter.
xylogen	(n.) Nascent wood; wood cells in a forming state.
xylogen	(n.) Lignin.
xylograph	(n.) An engraving on wood, or the impression from such an engraving; a print by xylography.
xylographer	(n.) One who practices xylography.
xylographic	(a.) Alt. of Xylographical
xylographical	(a.) Of or pertaining to xylography, or wood engraving.
xylography	(n.) The art of engraving on wood.
xylography	(n.) The art of making prints from the natural grain of wood.
xylography	(n.) A method pf printing in colors upon wood for purposes of house decoration.
xyloid	(a.) Resembling wood; having the nature of wood.
xyloidin	(n.) A substance resembling pyroxylin, obtained by the action of nitric acid on starch; -- called also nitramidin.
xylol	(n.) Same as Xylene.
xylonite	(n.) See Zylonite.
xylophaga	(n.) A genus of marine bivalves which bore holes in wood. They are allied to Pholas.
xylophagan	(n.) One of a tribe of beetles whose larvae bore or live in wood.
xylophagan	(n.) Any species of Xylophaga.
xylophagan	(n.) Any one of the Xylophagides.
xylophagides	(n. pl.) A tribe or family of dipterous flies whose larvae live in decayed wood. Some of the tropical species are very large.
xylophagous	(a.) Eating, boring in, or destroying, wood; -- said especially of certain insect larvae, crustaceans, and mollusks.
xylophagous	(a.) Of or pertaining to the genus Xylophaga.
xylophilan	(n.) One of a tribe of beetles (Xylophili) whose larvae live on decayed wood.
xylophilous	(a.) Of or pertaining to the xylophilans.
xylophone	(n.) An instrument common among the Russians, Poles, and Tartars, consisting of a series of strips of wood or glass graduated in length to the musical scale, resting on belts of straw, and struck with two small hammers. Called in Germany strohfiedel, or straw fiddle.
xylophone	(n.) An instrument to determine the vibrative properties of different kinds of wood.
xyloplastic	(a.) Formed of wood pulp by molds; relating to casts made of wood pulp in molds.
xylopyrography	(n.) The art or practice of burning pictures on wood with a hot iron; -- called also poker painting. See Poker picture, under Poker.
xyloquinone	(n.) Any one of a group of quinone compounds obtained respectively by the oxidation of certain xylidine compounds. In general they are yellow crystalline substances.
xylorcin	(n.) A derivative of xylene obtained as a white crystalline substance which on exposure in the air becomes red; -- called also betaorcin.
xylostein	(n.) A glucoside found in the poisonous berries of a species of honeysuckle (Lonicera xylosteum), and extracted as a bitter, white, crystalline substance.
xylotile	(n.) Same as Parkesine.
xylotrya	(n.) A genus of marine bivalves closely allied to Teredo, and equally destructive to timber. One species (Xylotrya fimbriata) is very common on the Atlantic coast of the United States.
xylyl	(n.) Any one of three metameric radicals which are characteristic respectively of the three xylenes.
xylylene	(n.) Any one of three metameric radicals, CH2.C6H4.CH2, derived respectively from the three xylenes. Often used adjectively; as, xylylene alcohol.
xyridaceous	(a.) Of or pertaining to a natural order (Xyrideae) of endogenous plants, of which Xyris is the type.
xyris	(n.) A genus of endogenous herbs with grassy leaves and small yellow flowers in short, scaly-bracted spikes; yellow-eyed grass. There are about seventeen species in the Atlantic United States.
xyst	(n.) Alt. of Xystus
xystarch	(n.) An office/ having the superintendence of the xyst.
xyster	(n.) An instrument for scraping bones.
xystus	(n.) A long and open portico, for athletic exercises, as wrestling, running, etc., for use in winter or in stormy weather.
