x	(danh từ) x.
x	(danh từ) 10 (chữ số la mã).
x	(danh từ) (toán học) ẩn số x.
x	(danh từ) yếu tố ảnh hưởng không lường được.
x-axis	(danh từ) (toán học) trục hoành.
x-efficiency	(danh từ) (kinh tế học) hiệu quả x.
x-rated	(tính từ) (nói về phim) cấm người dưới 18 tuổi xem; dành cho người lớn.
x-rated	(tính từ) (nói về phim) cấm người dưới 18 tuổi xem; dành cho người lớn.
x-ray	(danh từ) tia x, tia rơngen.
x-ray	(danh từ) (định ngữ) (thuộc) tia x.
x-ray	(ngoại động từ) chụp (ảnh bằng) tia x.
xanthate	(danh từ) (hoá học) xantat.
xanthic	(tính từ) (hoá học) xantic.
xanthine	(danh từ) (hoá học) xantin.
xanthippe	(danh từ) xanthippe người vợ lăng loàn.
xanthophyll	(danh từ) (thực vật học) xantofin.
xanthous	(tính từ) (nhân chủng học) vàng (da).
xbase	(danh từ) một thuật ngữ chung để chỉ tất cả các môi trường lập trình nào có xuất xứ từ ngôn ngữ lập trình gốc dbase của ashton-tate, inc vì từ dbase là một nhãn hiệu đã được cầu chứng, nên thuật ngữ xbase được sử dụng để mô tả bất kỳ ngôn ngữ lập trình nào dựa trên cơ sở dbase các ngôn ngữ xbase gồm có foxpro, dbase, clipper, arago, force.
xcmd	(danh từ) lệnh ngoại trú của dos.
xcnf	(danh từ) chức năng xcfn.
xebec	(danh từ) (hàng hải) thuyền xêbec, thuyền ba cột buồm (ở địa trung hải).
xenogamy	(danh từ) (thực vật học) sự giao phấn.
xenomorphic	(tính từ) (địa lý, địa chất) có dạng khác thường, dị hình.
xenon	(danh từ) (hoá học) xenon.
xenophilia	(danh từ) sự chuộng người nước ngoài, sự sùng ngoại.
xenophilous	(tính tư) chuộng người nước ngoài, sùng ngoại.
xenophobe	(tính từ) bài ngoại.
xenophobia	(danh từ) tinh bài ngoại.
xenophobic	(tính từ) ghét người nước ngoài, bài ngoại.
xerophagy	(tính từ) ăn khô; ăn khan.
xerophilous	(tính từ) ưa khô (cây).
xerophthalmia	(danh từ) (y học) bệnh khô mắt.
xerophyte	(danh từ) (thực vật học) cây ưa khô, cây chịu hạn.
xerox	(danh từ) kỹ thuật sao chụp không dùng mực ướt.
xerox	(ngoại động từ) sao chụp.
xhosa	(danh từ) người bantu ở nam phi.
xhosa	(danh từ) ngôn ngữ bantu.
xhosa	(tính từ) (thuộc) người bantu.
xia	(danh từ) như hsia.
xia	(danh từ) như hsia.
xin	(danh từ) như hsin.
xin	(danh từ) như hsin.
xiphoid	(tính từ) hình kiếm.
xiphoid	(danh từ) (giải phẫu) mẩu ức.
xmas	(danh từ) lễ nô-en.
xmodem	(danh từ) một giao thức truyền tệp không đồng bộ dùng cho máy tính cá nhân, để truyền không lỗi các tệp tin máy tính qua hệ thống điện thoại dễ dàng hơn.
xms	(danh từ) bộ nhớ xms.
xx	(danh từ) (từ mỹ) tờ 20 đô la.
xx	(danh từ) (viết tắt) của double-cross (từ lóng) sự lừa dối; sự phản bội.
xylem	(danh từ) (thực vật học) chất gỗ, xylem.
xylen	(danh từ) (hoá) xilen; xilol.
xylocarp	(danh từ) (thực vật học) quả mộc.
xylocarp	(danh từ) cây có quả mộc.
xylocarpous	(tính từ) (thực vật học) có quả mộc.
xylograph	(danh từ) bản khắc gỗ.
xylographer	(danh từ) thợ khắc gỗ.
xylography	(danh từ) thuật khắc gỗ.
xyloid	(tính từ) có gỗ; dạng gỗ; có linin.
xylonite	(danh từ) xenluloit.
xylophagous	(danh từ) (động vật học) ăn gỗ, đục gỗ (sâu bọ).
xylophone	(danh từ) (âm nhạc) đàn phiến gỗ, mộc cầm.
xyster	(đại từ) (y học) cái róc xương.
