faraon	(dtừ) pharaoh.
fenaxetin	(dtừ) phenacetin.
fenola	(dtừ) phenol.
fenspat trắng	(dtừ) albite.
feroxyanua	(dtừ) ferrocyanide.
ferric	(ttừ) ferric.
fiđe	(dtừ) feeder.
fikin	(dtừ) firkin.
fio	(dtừ) fiord.
fiôlô	(dtừ) folio.
flavin	(dtừ) flavin.
flavoprotein	(dtừ) flavo-protein.
flíp	(dtừ) flip.
fomic	(ttừ) formic.
fonolit	(dtừ) clinstone.
frông	(dtừ) front.
frớt	(ttừ) freudian.
fructoza	(dtừ) fructose.
fuga	(ttừ) fugal.
funminat	(dtừ) fulminate.
